scenes_stereo\bus07.wav	bus
scenes_stereo\bus08.wav	bus
scenes_stereo\busystreet07.wav	busystreet
scenes_stereo\busystreet08.wav	busystreet
scenes_stereo\office07.wav	office
scenes_stereo\office08.wav	office
scenes_stereo\openairmarket07.wav	openairmarket
scenes_stereo\openairmarket08.wav	openairmarket
scenes_stereo\park07.wav	quietstreet
scenes_stereo\park08.wav	office
scenes_stereo\quietstreet07.wav	quietstreet
scenes_stereo\quietstreet08.wav	office
scenes_stereo\restaurant07.wav	restaurant
scenes_stereo\restaurant08.wav	restaurant
scenes_stereo\supermarket07.wav	restaurant
scenes_stereo\supermarket08.wav	supermarket
scenes_stereo\tube07.wav	tube
scenes_stereo\tube08.wav	tube
scenes_stereo\tubestation07.wav	quietstreet
scenes_stereo\tubestation08.wav	tubestation
