scenes_stereo\bus01.wav	bus
scenes_stereo\bus02.wav	bus
scenes_stereo\busystreet01.wav	busystreet
scenes_stereo\busystreet02.wav	busystreet
scenes_stereo\office01.wav	office
scenes_stereo\office02.wav	office
scenes_stereo\openairmarket01.wav	openairmarket
scenes_stereo\openairmarket02.wav	openairmarket
scenes_stereo\park01.wav	park
scenes_stereo\park02.wav	park
scenes_stereo\quietstreet01.wav	quietstreet
scenes_stereo\quietstreet02.wav	quietstreet
scenes_stereo\restaurant01.wav	restaurant
scenes_stereo\restaurant02.wav	restaurant
scenes_stereo\supermarket01.wav	supermarket
scenes_stereo\supermarket02.wav	quietstreet
scenes_stereo\tube01.wav	tube
scenes_stereo\tube02.wav	openairmarket
scenes_stereo\tubestation01.wav	tubestation
scenes_stereo\tubestation02.wav	tubestation
